.........#.#.........
.........#.#.........
.........#.#.........
.........#.#.........
.........#.#.........
.........#.#.........
......####.####......
......#.......#......
#######.......#######
..........@..........
#######.......#######
......#.......#......
......####.####......
.........#.#.........
.........#.#.........
.........#.#.........
.........#.#.........
.........#.#.........
.........#.#.........
.....................
