~~~~~~~~~#.#~~~~~~~~~
~~~~~~~~~#.#~~~~~~~~~
~~~~~~~~~#.#~~~~~~~~~
~~~~~~~~~#.#~~~~~~~~~
~~~~~~~~~#.#~~~~~~~~~
~~~~~~~~~#.#~~~~~~~~~
~~~~~~####.####~~~~~~
~~~~~~#.......#~~~~~~
~#~#~##.......##~#~#~
.....................
..........@..........
#~#~#~#.......#~#~#~#
~~~~~~#.......#~~~~~~
......####.####......
.........#.#.........
.........#.#.........
.........#.#.........
.........#.#.........
.........#.#.........
.........#.#.........
.....................
