############################################################################
#..#..#.....#.....#........#.....#..#.................#..#.................#
#..#..####..#..#..####..#######..#..#..#######..#######..####..####..#..#..#
#..#.....#.....#..#.....#..#........#..#..#........#..#..#..#..#.....#..#..#
#..#..#######..#######..#..####..#######..#######..#..#..#..#############..#
#..#.....#..#.....#.....#..#......................................#..#.....#
#..#..####..#..#######..#..################..#..#..#..#######..####..####..#
#........#..#........#..............#.....#..#..#..#..#....................#
#..####..#..#######..#..#######..#######..#..#############..#######..####..#
#..#...........#..#........#..#..............#..............#...........#..#
#######..#..####..#..#..####..#..#######..####..#..####..##########..#..####
#........#...........#.....#.....#........#..#..#..#..#..#...........#.....#
####..#..##########..####..#..##########..#..#..####..##########..#..#..####
#.....#.....#...........#..#..#.....#........#..#........#.....#..#..#.....#
#..#..######################..####..################..####..##########..####
#..#..#..#..#..#..#..............#..#..#..#..#.................#...........#
#..#..#..#..#..#..##########..####..#..#..#..####..##########..####..#######
#..#..#..............#.....#..#..#.................#.................#..#..#
#######..#..#######..#..####..#..#######..#######..################..#..#..#
#..#..#..#..#...........#.....#..............#........#....................#
#..#..#..##########..#..#######..####..#..####..#..####..#######..#..####..#
#.....#..#..#........#..#..#.....#..#..#..#.....#..#.....#........#.....#..#
####..#..#..##########..#..#######..#..#..##########..#######..#..####..####
#.....#..#..#.....#....................#..#.................#..#.....#.....#
####..#..#..####..####..#..#..####..####..#######..#..##########..##########
#........#..#..#..#..#..#..#..#.....#.....#........#...........#........#..#
####..####..#..#..#..#..#######..#..####..####..####..##########..####..#..#
#..#.....#.................#.....#..#.....#..#.....#........#........#.....#
#..#############..####..##########..#######..####..#..#..#..####..####..####
#..#..#.....#.....#........#..#..#..#..............#..#..#..#..#.....#..#..#
#..#..####..####..#..#######..#..##########..#..##########..#..#..####..#..#
#..#..#...........#..#..#....................#...........#..#........#.....#
#..#..#..#############..####..####..#..####..####..##########..#######..#..#
#...........#.....#.....#..#..#.....#..#.....#.....#..#.....#..#..#.....#..#
####..##########..####..#..#######..#..#..#..####..#..####..#..#..####..####
#........#..........................#..#..#.....#..#..#..#........#........#
#..#..##########..#..#..#..####..#######..#..#..####..#..####..#..####..####
#..#.....#........#..#..#.....#..#........#..#..#..............#..#........#
#..#..##########..#######..####..#######..####..#..#..#..#..#..#######..#..#
#..#..#........#..#........#..#..#..#.....#.....#..#..#..#..#.....#.....#..#
####..#..####..##########..#..#..#..#..####..#..####..#..#..#..####..#..####
#.....#..#........#..#..#.....#.....#..#..#..#.....#..#..#..#..#.....#..#..#
####..#######..####..#..#############..#..####..#######..#..#######..#..#..#
#.....#.....#..........................#..............#..#..#........#.....#
####..####..####..####..####..####..####..#..#..#######..####..#..#..#..####
#.....#........#..#.....#..#..#........#..#..#.....#........#..#..#..#.....#
##########..#..#######..#..#..#######..####..####..##########..#..#..#..#..#
......#.....#..#........#.....#..#..#..#..#..#........#.....#..#..#..#..#..#
...#..#######..####..##########..#..####..#..####..#######@@#..####..####@@#
...#....................#.......................#..#......@@......#..#...@@#
...#########################################################################
